2 10 379 1158 3781 3789 2393 1007 3817 2796 1125 408 
2 2 408 3905 
1 2 2019 4266 
2 13 3905 1910 3921 1345 813 2817 3944 683 3974 756 4021 2926 4084 
2 32 4084 2222 4095 735 1223 32 1090 2125 1766 2203 2008 861 4138 4149 4150 789 4126 1686 2161 2523 4153 720 4142 1883 4161 2270 2558 367 4195 1275 4224 2019 
1 19 588 3675 3718 701 3787 1661 2078 584 758 3955 3979 638 1770 4063 2571 543 4188 4213 2019 
1 16 3575 2483 3556 3553 228 2622 702 1490 480 1991 3596 2762 1163 2980 3623 588 
1 23 588 3640 1757 3614 3613 229 1803 624 1307 1237 2552 1689 577 654 3488 697 2097 3410 904 3378 3354 3331 3306 
1 32 3905 1910 3921 1345 813 2361 450 1986 416 540 3782 2662 1190 3724 907 3666 2984 3626 1948 3600 3559 3534 555 1000 3439 2347 1777 3356 1459 473 3331 3306 
2 24 379 3775 1214 3844 1619 2846 3961 142 4014 2569 2606 4112 301 4160 4183 1555 4204 4245 2541 2266 2423 4340 1253 4361 
1 14 4361 1617 891 188 317 343 1639 2757 1204 4129 2386 1529 609 2926 
1 17 759 803 1346 3583 3606 2793 3625 529 3673 182 804 3659 782 3686 3700 247 379 
1 9 3618 1252 705 3731 3757 3785 2119 3857 2527 
1 15 2103 1176 3996 3983 888 1860 1750 618 3933 3915 2121 2681 307 944 2527 
1 6 3487 3511 905 3513 156 1826 
1 7 3487 2287 766 2434 3332 3320 1581 
1 7 1581 2890 1650 1567 31 3478 1826 
1 9 1826 1561 1613 2789 1877 3462 2220 347 2085 
1 7 3618 335 2415 1486 3486 3457 2085 
1 24 1581 1437 2525 501 3209 2435 1497 3158 3149 2610 2208 3138 1126 3117 3103 153 3076 3071 177 3063 1926 2064 2233 3056 
1 16 481 1104 1729 2925 1706 645 1512 1568 1012 2192 1220 225 2580 2020 297 2179 
1 17 2179 4428 4444 530 2675 331 2232 2530 4478 4485 2691 4497 4507 4516 2039 2939 3013 
1 8 2103 80 2464 545 781 2923 573 481 
1 12 2859 4288 63 1444 4330 9 1616 2764 1117 1973 65 2179 
1 12 775 908 1140 4159 385 2657 2158 4205 4256 4275 2560 2859 
1 12 2859 2195 4280 265 2430 1269 4264 4291 4283 55 4268 730 
1 4 2103 671 4107 775 
1 18 1112 3021 2414 2123 4518 1846 1781 2822 2989 4514 2095 4509 571 4517 707 36 4540 3013 
1 16 4424 933 2806 943 4445 365 2786 2190 864 1527 4484 1823 2015 1366 4511 1112 
1 12 1112 2024 2686 4467 1494 1095 4442 531 2300 558 1253 4361 
1 18 2527 130 3866 3862 2790 1284 2743 1660 3798 258 1312 215 3758 1767 492 2698 221 379 
1 9 4424 4408 4390 4375 635 3006 2522 4311 730 
1 16 730 2537 2628 2609 2472 559 2915 2410 4322 4316 2224 4336 298 2658 1253 4361 
1 6 410 2466 2392 4212 2798 2859 
1 34 3056 3062 3070 1887 1700 1382 3089 35 2677 1958 2500 3146 268 1141 1434 3204 2243 3233 1593 1299 3205 1864 2751 3242 1082 2225 1591 3247 767 3277 2467 257 909 3306 
