2 2 298 1364 
1 7 521 944 1830 1006 1795 787 1752 
1 6 2063 2056 2045 885 279 2011 
2 6 2063 798 95 2042 171 785 
2 13 1697 1685 98 1156 20 236 914 1369 342 439 395 1843 1841 
1 7 298 1881 1337 578 840 1832 529 
1 8 1752 1735 174 255 232 1392 662 1647 
1 7 1697 1706 917 169 1731 179 138 
1 8 744 1080 1180 745 384 1352 758 138 
2 13 893 525 1038 290 1982 1970 1186 899 132 478 1380 1080 744 
2 9 212 862 1207 1300 1147 996 638 297 962 
2 6 593 706 1231 254 930 962 
1 6 2063 798 844 103 1145 218 
2 11 14 1289 563 2131 997 2125 33 2109 915 2102 1124 
2 4 218 374 554 1124 
1 9 1101 1929 28 1301 1992 337 1353 893 212 
1 8 1101 1895 1874 261 1842 114 336 138 
2 9 182 1607 747 1585 1001 1555 748 1516 273 
1 10 1506 466 541 483 1492 520 141 843 686 273 
1 11 1167 1212 1040 1489 890 216 1512 282 1521 1513 1523 
1 9 898 610 1628 1259 186 1682 192 485 331 
1 14 1647 662 1272 303 1625 817 338 1280 916 859 111 1615 610 898 
1 13 1167 1317 1459 1456 324 833 1284 1441 1434 227 1443 87 1335 
2 8 1544 1551 364 1004 1539 637 1550 53 
1 8 898 61 1588 1330 130 1574 1371 53 
1 11 498 871 1197 509 622 1411 537 1605 117 1561 1544 
1 13 1787 1220 913 796 1720 1703 678 1648 1631 251 1603 108 1371 
1 7 1349 550 894 1877 1864 1091 1839 
1 5 1206 1801 827 329 422 
2 7 1206 1848 766 841 490 386 1349 
1 7 1206 1189 353 368 1855 438 521 
1 4 532 1792 148 1206 
1 7 532 464 1152 1753 1718 487 678 
2 2 476 1218 
2 3 476 1291 401 
1 3 405 715 2081 
1 9 767 1530 905 958 877 949 1545 326 1544 
1 7 370 1462 1469 1484 495 805 1523 
1 9 529 1087 1814 426 1800 445 969 1794 448 
1 9 1971 1947 1036 966 675 1232 139 988 448 
1 6 448 429 991 1868 690 298 
1 9 171 2028 220 50 580 964 332 77 2067 
1 3 2119 63 217 
1 10 1108 839 599 1344 824 2126 270 835 1030 1094 
1 4 1067 1026 2123 33 
1 4 230 453 2150 14 
1 3 14 546 2137 
2 5 2090 811 2095 2093 593 
1 7 1651 1279 508 1251 577 892 138 
1 7 971 470 412 454 1307 943 843 
1 4 313 657 1568 747 
1 6 916 1595 356 1203 1174 1523 
1 8 1335 661 442 225 1500 1011 1531 1544 
1 16 1647 772 245 956 1092 291 113 865 1675 131 1692 134 1741 605 1071 1757 
1 9 1757 598 8 378 1781 1033 365 812 439 
2 4 2010 911 1270 1349 
1 3 521 1383 1921 
1 7 1921 462 1025 879 328 1062 401 
1 5 232 1695 302 91 1663 
1 4 1663 1673 267 115 
1 4 1663 1691 47 1752 
1 3 115 1032 450 
1 3 516 133 1752 
1 4 516 635 446 255 
2 4 911 15 269 288 
2 3 288 1996 401 
1 4 1839 18 1804 1787 
1 2 1787 498 
1 5 1848 1858 1852 240 1864 
1 8 1025 162 783 1927 357 56 1906 841 
1 8 1921 491 1935 1384 1930 150 1926 588 
1 7 588 612 776 912 1913 673 1364 
1 7 588 511 1286 456 533 1308 2011 
1 3 960 524 533 
1 11 476 2039 334 2024 1047 951 530 1985 416 160 1980 
1 6 1921 423 241 286 1994 1047 
1 7 1647 1672 903 191 459 780 1779 
1 4 588 119 1893 137 
1 6 137 358 1825 617 784 516 
1 3 780 388 529 
1 3 1779 1003 445 
1 7 785 1974 1271 1945 934 1261 298 
1 2 1364 1261 
1 5 1647 1629 1612 1601 1586 
1 8 273 728 1329 1130 1191 394 1112 1586 
1 9 1757 1769 109 1766 1281 573 1059 1805 448 
1 5 1757 1318 1073 1378 621 
1 4 1980 1042 1956 588 
1 7 1795 1776 450 1762 331 731 422 
1 2 1506 495 
1 3 1417 1426 227 
1 5 1757 1745 624 595 1723 
1 8 1723 367 189 1127 1015 96 41 1156 
1 6 621 954 1643 321 752 1622 
2 4 287 609 1409 1987 
1 9 1971 575 1957 1245 299 1243 562 1923 874 
1 4 874 1398 1110 1841 
1 6 287 425 1934 1925 719 874 
1 8 874 1918 553 1960 372 30 2007 724 
1 5 1987 2006 1098 276 724 
1 6 724 574 1168 44 792 2036 
1 4 2036 2030 668 1995 
1 5 1995 43 793 1138 553 
1 6 1971 323 46 2017 629 2036 
1 4 785 897 1983 1971 
1 8 287 1936 348 658 256 233 545 1895 
1 5 1723 1767 457 1791 439 
1 4 1622 292 631 400 
1 3 177 1215 400 
1 4 400 1658 842 98 
1 3 2036 1137 332 
1 11 2067 1068 144 1090 2085 721 1116 391 561 938 1124 
1 2 218 1116 
1 5 2143 614 887 2140 2137 
1 5 2092 238 2105 2110 253 
1 5 253 2124 1356 625 2137 
1 5 2092 983 2091 1365 2090 
1 5 2067 2077 2080 933 2092 
1 5 593 1172 295 346 2117 
1 3 2057 1037 254 
1 5 2057 2051 2048 1255 724 
1 5 883 2 1250 252 287 
1 5 1987 2001 514 1121 2 
1 6 297 102 2029 846 941 883 
1 4 883 708 1327 28 
1 6 1101 431 1358 1914 799 1186 
1 6 744 197 379 740 978 1709 
1 2 1279 826 
1 5 1773 250 1257 583 236 
1 5 1697 788 1293 1750 1773 
