2 2 298 1364 
2 19 1364 673 536 504 1286 1181 1042 187 1958 1966 1976 1221 1972 1310 1994 79 641 2012 401 
2 9 521 1076 535 770 1025 879 328 1062 401 
1 6 521 944 1830 1006 1795 1253 
1 6 2063 2056 2045 885 279 2011 
1 5 2011 1308 533 456 1181 
2 8 1971 1983 1410 171 2042 95 798 2063 
2 7 1971 1235 1196 965 934 1261 298 
1 5 1971 575 142 1245 299 
1 6 299 1243 562 1907 1398 1213 
2 4 1213 6 1843 395 
2 11 1697 1685 98 1156 20 236 914 1369 342 439 395 
1 7 298 1881 1337 578 840 1832 529 
1 8 529 1169 1028 784 1789 235 787 1253 
1 8 529 388 1765 459 1159 903 1672 1647 
1 9 1253 1752 1735 174 255 232 1392 662 1647 
2 10 1647 1629 1612 322 1569 1191 1130 249 728 273 
1 9 935 336 1219 179 1731 169 917 1706 1697 
1 7 744 1080 1180 745 384 1381 935 
1 2 99 570 
1 7 1213 1077 1901 558 425 287 99 
1 6 570 1987 1991 2000 2007 724 
2 13 893 525 1038 290 1982 1970 1186 899 132 478 1380 1080 744 
2 8 654 638 996 1147 1300 1207 862 212 
2 5 654 667 2078 706 593 
1 6 1124 554 103 844 798 2063 
2 11 14 1289 563 2131 997 2125 33 2109 915 2102 1124 
2 7 2068 552 909 218 374 938 1124 
1 5 427 77 332 964 2068 
1 5 724 1255 2044 2054 427 
1 9 1101 1929 28 1301 1992 337 1353 893 212 
1 7 935 347 1842 261 1874 1895 1101 
2 9 182 1607 747 1585 1001 1555 748 1516 273 
2 17 182 734 396 1634 954 1643 1035 1659 284 753 170 403 1658 842 98 1685 1697 
1 10 1506 466 541 483 1492 520 141 843 686 273 
1 13 1167 1212 1040 1489 890 216 1199 1507 23 920 805 495 1506 
1 10 422 1748 1171 192 1682 186 1259 1628 610 898 
1 7 422 731 331 1762 450 1776 1253 
1 14 1647 662 1272 303 1625 817 338 1280 916 859 111 1615 610 898 
1 13 1167 1317 1459 1456 324 833 1284 1441 1434 227 1443 87 1335 
2 8 1544 1551 364 1004 1539 637 1550 53 
1 8 898 61 1588 1330 130 1574 1371 53 
1 10 498 871 1197 509 622 1411 1390 117 1561 1544 
1 13 53 108 1603 251 1631 1648 678 1703 1720 796 913 1220 1787 
1 11 1349 550 894 1877 1864 355 655 18 1804 1787 498 
2 8 401 1996 288 269 15 611 1961 1349 
1 5 1206 1801 827 329 422 
2 7 1206 1848 766 841 490 386 1349 
1 7 1206 1189 353 368 1855 438 521 
1 4 532 1792 148 1206 
1 7 532 464 1152 1753 1718 487 678 
1 15 1364 673 1913 1903 1894 70 1880 358 697 1818 869 1803 257 787 1253 
1 3 960 524 1308 
1 2 476 1218 
2 3 476 1291 401 
1 3 405 715 2081 
1 2 1839 18 
1 9 767 1530 905 958 877 949 1545 326 1544 
1 5 370 1462 1469 1484 495 
1 10 1059 1782 1794 969 445 1800 426 1814 1087 529 
1 9 1059 1807 768 572 675 966 1036 1947 1971 
1 8 1059 1805 448 429 991 1868 690 298 
1 4 1059 573 993 1741 
1 10 724 574 1351 1995 829 421 335 1233 323 1971 
1 5 964 580 50 220 1410 
1 3 2119 63 217 
1 3 1108 600 2132 
1 5 2132 599 1344 824 2126 
1 3 2126 2129 835 
1 3 835 1030 1094 
1 4 1067 1026 2123 33 
1 4 230 453 2150 14 
1 7 14 546 2137 625 2127 568 253 
2 7 2090 5 945 2098 48 691 253 
1 8 654 184 930 1298 2046 735 276 724 
1 5 2090 811 2095 2093 593 
2 6 2090 1400 581 2075 1037 2046 
1 5 2090 2099 78 1377 2117 
1 9 1651 1279 508 1251 687 1764 1388 758 935 
1 9 1101 1922 1214 84 256 658 348 1936 287 
1 7 971 470 412 454 1307 943 843 
1 4 313 657 1568 747 
1 4 177 1215 400 403 
1 6 805 1174 1203 356 1595 916 
1 8 1335 661 442 225 1500 1011 1531 1544 
1 13 1647 772 245 956 1092 291 113 865 1675 131 1692 134 1741 
1 9 1741 605 1769 598 8 378 1781 1033 365 
1 3 365 812 439 
