2 2 298 1364 
1 3 1752 787 1795 
1 14 2063 2056 2045 885 279 2011 1308 524 960 2021 2003 2004 592 1980 
2 3 2042 171 785 
2 8 1841 1843 395 439 342 1369 914 236 
2 5 529 1832 193 1878 1894 
1 8 1752 1735 174 255 232 1392 662 1647 
1 3 1731 179 138 
1 7 132 85 1357 1105 1381 758 336 
2 13 893 525 1038 290 1982 1970 1186 899 132 478 1380 1080 744 
2 9 212 862 1207 1300 1147 996 638 297 962 
2 6 593 706 1231 254 930 962 
1 6 2063 798 844 103 1145 218 
2 11 1124 2102 915 2109 33 2125 997 2131 563 101 2137 
2 4 218 374 554 1124 
1 9 1101 1929 28 1301 1992 337 1353 893 212 
1 8 1101 1895 1874 261 1842 114 336 138 
1 7 1506 466 541 483 1492 520 141 
1 11 1523 62 830 282 1512 216 890 1489 1247 1146 1167 
1 14 731 1740 1171 1029 760 110 1689 127 1653 1636 571 1609 727 1574 
1 14 1647 662 1272 303 1625 817 338 1280 916 859 111 1615 610 898 
1 13 1167 1317 1459 1456 324 833 1284 1441 1434 227 1443 87 1335 
2 8 1544 1551 364 1004 1539 637 1550 53 
1 8 898 61 1588 1330 130 1574 1371 53 
1 9 1544 1561 117 1605 537 1621 1642 591 678 
1 12 1220 913 796 1720 1703 678 1648 1631 251 1603 108 1371 
1 7 1349 550 894 1877 1864 1091 1839 
1 6 1206 1801 827 329 422 731 
2 8 1349 386 490 841 766 1848 968 1206 
1 9 1206 1189 353 368 1855 438 521 1383 1921 
1 4 532 1792 148 1206 
1 7 532 464 1152 1753 1718 487 678 
2 2 476 1218 
2 3 476 1291 401 
1 5 3041 360 405 2084 473 
1 7 767 1530 905 958 877 949 1526 
1 10 1523 805 495 1484 1469 1462 370 3250 3267 3273 
2 9 529 1087 1814 426 1800 445 969 1794 448 
1 9 1971 1947 1036 966 675 1232 139 988 448 
2 6 448 429 991 1868 690 298 
1 5 171 2028 220 50 580 
1 3 2119 63 217 
1 8 1108 839 599 1344 824 2126 270 652 
1 13 230 453 2150 14 666 2148 222 88 596 1067 1026 2123 33 
1 3 14 546 2137 
1 8 1651 1279 508 1251 577 1764 1388 758 
1 13 141 1481 943 1307 454 412 470 971 3715 3729 3719 3718 3710 
1 6 916 1595 356 1203 1174 1523 
1 9 1335 661 442 225 1511 1526 1011 1531 1544 
1 9 113 865 1675 771 1714 1741 605 1071 1757 
1 9 1757 598 8 378 1781 1033 365 812 439 
2 4 2010 911 1270 1349 
1 6 1921 462 1025 879 328 1062 
1 5 1663 91 302 1695 174 
1 4 1663 1673 267 115 
1 4 516 635 446 255 
2 8 401 1996 288 269 677 1954 1258 1927 
1 5 1839 18 1804 1787 1220 
1 5 1864 240 1852 1858 766 
1 4 1025 162 783 1927 
1 8 1921 491 1935 1384 1930 150 1926 588 
1 8 1364 673 1913 1903 1894 70 1880 137 
1 4 779 1959 456 1181 
1 11 476 2039 334 2024 1047 951 530 1985 416 160 1980 
1 6 1921 423 241 1016 1978 79 
1 4 588 119 1893 137 
1 6 137 358 1825 617 784 516 
1 3 780 388 529 
1 3 1779 1003 445 
2 8 298 1261 934 1945 1271 1974 1148 785 
1 2 1364 1261 
1 4 1586 322 847 1624 
1 8 1757 1769 109 1766 1281 1809 768 139 
1 5 1757 1318 1073 1688 1667 
1 2 1956 588 
1 2 1506 495 
1 3 1417 1426 227 
1 5 1757 1745 624 595 1723 
1 7 1723 367 189 1127 1015 1340 236 
1 9 1638 937 752 321 1643 954 621 1668 1667 
2 4 287 609 1409 1987 
1 9 1971 575 1957 1245 299 1243 562 1923 874 
1 4 874 1398 1110 1841 
1 7 874 719 1200 34 558 1164 1936 
1 8 874 1918 553 1960 372 30 2007 724 
1 5 1987 2006 1098 276 2048 
1 6 724 574 1168 44 792 2036 
1 4 2036 2030 668 1995 
1 5 1995 43 793 1138 553 
1 6 1971 323 46 2017 629 2036 
2 4 785 897 1983 1971 
1 8 287 1936 348 658 256 233 545 1895 
1 5 1723 1767 457 1791 439 
1 8 400 1215 1599 1584 226 705 317 1622 
1 7 400 984 1662 569 1216 377 1706 
1 4 2036 1137 332 144 
1 10 2067 1068 144 1090 2085 721 1116 391 561 915 
1 2 218 1116 
1 12 2085 1321 11 713 2103 2111 492 568 1356 861 887 614 
1 11 593 1172 295 346 2117 2120 407 1023 567 1162 2143 
1 3 2057 1037 254 
1 3 2057 2051 2048 
1 5 883 2 1250 252 287 
1 5 1987 2001 514 1121 2 
1 6 297 102 2029 846 941 883 
1 4 883 708 1327 28 
1 2 1279 826 
1 3 1257 583 236 
1 6 1706 788 1293 1750 250 860 
1 8 681 1746 406 1396 1774 1763 993 1766 
1 3 681 1778 445 
1 4 1763 1059 1805 448 
2 5 1868 782 1845 515 445 
1 7 1913 536 779 725 1977 1290 279 
1 9 1441 1445 556 399 743 876 205 1287 637 
1 7 1489 1496 1508 1517 310 586 130 
1 15 1667 74 1649 1223 125 1278 129 1192 1083 1583 204 1576 1591 1569 394 
1 8 114 1269 1086 268 813 1798 860 1257 
1 7 574 1351 1995 829 421 315 1957 
1 4 1148 1990 2002 1290 
1 4 1903 1919 612 511 
1 2 511 1956 
1 4 916 882 482 1663 
1 5 61 1341 1315 1543 282 
1 8 2131 726 2114 888 2104 2096 1294 2085 
1 4 580 552 909 218 
1 13 2057 37 2076 59 112 983 2092 238 48 2112 2116 201 1023 
1 5 962 280 922 123 1987 
1 8 826 1285 928 449 1780 1797 852 744 
1 12 141 1504 1519 1532 394 1112 1319 1565 26 884 1282 1203 
1 3 220 604 2017 
2 4 1947 318 45 1884 
1 6 1884 1867 648 211 1131 378 
1 7 874 1907 854 1107 1870 1126 648 
1 5 1884 803 1292 58 768 
1 11 439 140 1299 1836 1362 75 410 1872 669 1345 233 
1 6 1936 1376 413 1072 1141 1362 
1 4 1299 152 327 1843 
1 5 2067 2065 477 1275 2048 
1 5 1766 963 1824 1399 648 
1 7 635 281 1747 737 1765 780 1779 
1 3 529 1169 1825 
2 6 1232 54 325 1933 965 1945 
1 3 690 1897 54 
1 4 1933 1196 1235 1971 
1 5 2042 688 925 165 844 
1 4 1945 1955 973 1977 
1 4 45 1022 672 299 
1 10 191 1727 665 1393 990 627 769 1729 834 771 
1 4 191 1159 1730 1747 
1 2 429 1833 
1 2 969 1816 
1 4 58 572 1354 966 
1 4 966 1917 749 1933 
1 5 885 2032 247 2020 785 
1 8 577 1733 371 825 1716 169 917 1706 
1 6 1662 842 1156 1726 1734 1257 
1 7 1101 431 1151 1088 1964 1054 1982 
1 6 593 2093 166 2088 1400 59 
1 6 2143 614 2144 2146 2140 2137 
1 4 11 2087 736 1068 
1 9 59 312 810 729 2067 77 332 49 580 
1 4 477 2044 1100 574 
1 7 2088 811 2099 307 1350 458 2116 
1 5 824 2133 1094 1346 2139 
1 4 299 1912 987 1870 
1 8 1622 1638 753 1665 1129 319 121 1156 
1 6 1845 90 1337 1879 1187 1903 
1 4 1985 1221 756 1930 
1 5 1927 1332 1179 601 353 
1 7 1930 1002 65 1865 1835 1815 1795 
1 4 137 330 86 1865 
1 5 521 944 1854 1133 1835 
1 6 731 1783 994 1812 1821 368 
1 9 1133 1830 730 618 864 1762 1732 1158 93 
1 4 618 1154 52 994 
1 6 115 970 1737 1752 133 516 
1 4 817 1632 680 302 
1 4 2010 1375 1998 269 
1 4 1954 698 1938 386 
1 6 766 1891 1876 1048 1890 1179 
1 8 1647 772 1624 845 145 1611 1166 1192 
1 3 662 786 1159 
1 13 1532 939 1540 1130 900 602 1336 1516 273 1493 345 1471 1307 
1 18 705 739 1600 1114 1123 1571 895 867 544 1563 657 1527 128 1194 764 1485 889 345 
1 14 958 518 1579 1598 1617 1382 755 1322 1683 293 502 1749 871 1220 
1 10 1531 392 1497 118 579 393 399 712 819 1459 
1 4 117 1594 1608 1617 
1 5 898 126 497 1620 571 
1 5 464 858 1704 415 1653 
1 8 890 1488 190 1474 213 1373 381 1462 
1 5 1523 1513 23 1486 1474 
1 12 483 1480 809 1027 1446 1060 1442 3265 3274 3289 3310 3319 
1 20 4278 4265 4262 4219 4240 4226 4209 4197 4176 4167 4147 4128 2198 4078 4079 4076 4056 4034 4021 4014 
1 11 4221 4216 4223 2217 4212 4201 4209 4213 4218 2712 4210 
1 7 4014 4001 3977 3957 3926 3895 1651 
1 9 3885 3882 3877 3873 3867 3868 3863 740 1780 
1 10 3885 3889 3900 3916 3934 3949 3965 3989 4002 4022 
1 8 4022 4045 4074 4094 4109 4131 4158 4176 
1 7 3926 3940 3959 3970 3976 3990 4002 
1 8 4014 3994 3967 4312 3944 3929 3911 1216 
1 12 4014 4016 4025 4027 2865 4020 4032 4049 3588 3579 3582 3609 
1 4 3609 3602 3586 3577 
1 4 3577 3568 3560 867 
1 5 3579 3566 3555 3552 1123 
1 7 3671 3667 3645 3640 3631 3620 3609 
1 7 3010 2860 3803 3781 3763 3735 3715 
1 7 3814 3792 3777 3755 3746 3726 3710 
1 9 3814 3822 3823 3824 3827 2450 2874 2746 3010 
1 6 3769 3768 3772 3776 3778 3792 
1 6 3769 3745 3721 3700 3686 3671 
1 9 3710 3711 3709 3693 3687 3678 3662 3651 3631 
1 3 3667 3664 3678 
1 12 3577 3584 3592 3598 3603 3618 3633 3652 3665 3681 3694 3710 
1 6 3633 3623 3619 3616 555 1485 
1 4 2712 4224 4242 4243 
1 11 4243 4314 4220 4233 4238 3699 3697 3692 3677 3666 3671 
1 15 3769 3771 3767 3753 3748 3744 3754 3743 3734 3752 3737 4272 2491 4254 4243 
1 13 4262 4264 4275 4276 4280 4291 4292 4293 4298 4299 4306 4309 4311 
1 5 4299 2472 4287 4282 2491 
1 20 4210 4207 4199 2329 4190 4186 4180 4161 4135 2616 4101 4084 4061 4070 4059 4032 4024 4007 3982 1584 
1 3 4220 4205 4190 
1 7 4076 4096 4120 4143 4148 4165 4180 
1 5 4070 4103 4129 3654 3671 
1 16 4221 4202 4182 4156 4144 4127 4095 4057 4043 4015 3987 3954 3938 3910 3896 3885 
1 5 4278 4266 4252 4245 4221 
1 9 3609 3621 3627 3639 3655 3668 3679 3696 3710 
1 6 3693 3674 3668 3649 3644 3633 
1 15 4330 4332 4336 4337 4347 4349 4358 4359 4371 4382 4391 4400 4398 4405 4404 
1 5 4319 4322 4325 4329 4337 
1 7 4490 4483 4469 4460 4435 4424 4404 
1 14 4561 4563 4555 4551 4541 4539 4528 4510 4509 4505 4503 4500 4495 4490 
1 10 4490 4496 4494 4512 4513 4516 4543 4557 4575 4581 
1 6 4543 4537 4545 4572 4585 4596 
1 10 4596 4586 4576 4587 4569 4559 4566 4573 4560 4541 
1 3 4573 4593 4605 
1 6 4586 4564 4546 4524 4508 4500 
1 15 4510 4492 4478 4461 4439 4422 4407 4386 4395 4385 4383 4384 4380 4394 4404 
1 9 4371 4393 4426 4446 4458 4479 4499 4525 4543 
1 8 4426 4411 4408 4397 4381 4362 4350 4336 
1 3 4358 4378 4397 
1 3 4408 4429 4450 
1 3 4400 4414 4430 
1 4 4499 4476 4455 4430 
1 4 4455 4452 4453 4460 
1 3 4380 4355 4339 
1 11 4404 4410 4419 4416 4433 4449 4465 4471 4489 4497 4510 
1 10 3814 3813 3815 3811 3798 3786 3789 3780 3775 3781 
1 9 3010 2762 2470 2617 3834 3844 3402 3414 3412 
1 7 3319 3333 3323 3334 3331 3779 3781 
1 9 3412 3400 3397 3387 3375 3361 3353 3336 3319 
1 7 3486 3475 3465 3453 3442 3427 3412 
1 7 3436 3440 3434 3431 3438 3439 3427 
1 5 3170 3186 3189 3432 3436 
1 5 3529 2686 2339 2165 2300 
1 5 2300 3519 3202 3198 3186 
1 15 2686 2773 3530 3505 3504 3502 3499 3496 3491 3484 3479 3473 3471 3463 3465 
1 6 3436 3448 3459 3470 3482 3499 
1 5 3473 3462 3456 3443 3440 
1 7 3540 3544 3543 3546 3542 3539 3536 
1 3 3551 3550 3544 
1 6 2300 2804 2168 3518 3460 3459 
1 11 3204 3197 3194 3195 3182 3179 3178 3176 3174 3175 3170 
1 7 2300 2936 3211 3200 3201 3192 3195 
1 7 3529 3527 3526 3218 3214 3209 3195 
1 22 3147 3138 3149 3151 3142 3039 3126 3119 3112 3111 3107 3098 3084 3075 3073 3080 3076 3099 3118 3136 3155 3170 
1 5 3197 3187 3177 3158 3142 
1 5 3179 3157 3139 3121 3107 
1 7 1417 223 3071 3081 3086 3094 3107 
1 11 1335 1043 1361 590 309 31 707 3091 3105 3114 3138 
1 6 1417 685 1416 946 1415 31 
1 5 833 19 3055 3064 3075 
1 7 3076 3063 3053 3052 3269 3253 3241 
1 10 3241 3252 3260 3266 3278 3273 3284 3301 3306 3319 
1 3 3241 3227 190 
1 11 3319 3324 3325 3328 3326 3327 3322 3329 3330 3079 3076 
1 10 3412 3424 3418 3423 3415 3410 3408 3405 3159 3170 
1 15 3436 3429 3420 3410 3396 3384 3371 3354 3332 3322 3299 3293 3281 3262 3241 
1 6 3353 3358 3362 3350 3366 3371 
1 5 3412 3407 3392 3373 3366 
1 19 5394 5391 5374 5362 5359 5350 5347 5324 5316 5291 5288 5282 5260 5228 5220 5194 5183 5206 5213 
1 15 5397 5385 5375 5355 5347 5321 5305 5284 5253 5239 5229 5236 5246 5238 5233 
1 9 5233 5208 5170 5156 5134 5102 5059 5025 4992 
1 13 5213 5191 5154 5129 5091 5067 5035 4996 4964 4908 4909 4876 4848 
1 7 4750 4782 4793 4783 4800 4836 4848 
1 8 4616 4619 4626 4637 4653 4671 4708 4750 
1 7 4792 4819 4802 4807 4810 4828 4848 
1 3 5285 5255 5217 
1 10 5217 5242 5245 5249 5250 5235 5256 5261 5252 5233 
1 8 5072 5099 5112 5137 5193 5214 5221 5233 
1 7 5052 5048 5080 5113 5111 5105 5112 
1 5 5072 5033 4971 4932 4906 
1 7 5052 5010 5011 4978 4947 4945 4906 
1 6 4906 4900 4881 4861 4862 4842 
1 7 4992 4957 4942 4917 4869 4872 4842 
1 6 4992 4960 4930 4888 4896 4868 
1 8 4992 4987 4963 4980 5016 5042 5039 5072 
1 11 5261 5278 5295 5308 5310 5329 5333 5345 5335 5315 5285 
1 7 5217 5201 5195 5187 5167 5140 5111 
1 5 5194 5174 5139 5116 5091 
1 8 4792 4805 4827 4826 4832 4856 4877 4868 
1 6 4714 4718 4724 4763 4788 4792 
1 6 4714 4747 4773 4774 4825 4868 
1 9 4633 4643 4660 4701 4712 4757 4770 4796 4842 
1 12 4660 4661 4651 4679 4703 4717 4677 4698 4705 4691 4710 4714 
1 11 4906 4859 4855 4830 4790 4771 4732 4681 4675 4640 4633 
1 4 4796 4778 4752 4717 
1 14 5134 5120 5124 5130 5118 5119 5121 5125 5135 5152 5162 5168 5173 5174 
1 6 5253 5210 5185 5182 5158 5121 
1 8 4868 4913 4952 4982 5000 5036 5098 5121 
1 11 5067 5060 5041 5006 4983 4944 4940 4878 4865 4864 4827 
1 7 5121 5090 5068 5005 4986 4975 4940 
1 12 4724 4699 4706 4658 4652 4638 4634 4632 4622 4621 4618 4619 
1 7 4638 4659 4689 4715 4744 4761 4800 
