2 2 298 1364 
2 19 1364 673 536 504 1286 1181 1042 187 1958 1966 1976 1221 1972 1310 1994 79 641 2012 401 
2 9 521 1076 535 770 1025 879 328 1062 401 
1 6 521 944 1830 1006 1795 1253 
1 6 2063 2056 2045 885 279 2011 
1 6 2011 1308 533 456 1181 1042 
2 8 1971 1983 1410 171 2042 95 798 2063 
2 7 1971 1235 1196 965 934 1261 298 
1 5 1971 575 142 1245 299 
1 6 299 1243 562 1907 1398 1213 
2 4 1213 6 1843 395 
2 8 598 906 1131 1806 1033 365 812 395 
2 11 1697 1685 98 1156 20 236 914 1369 342 439 395 
2 10 969 1816 429 1844 1232 675 966 1036 1947 1971 
1 7 529 1087 1814 426 1800 445 969 
1 7 298 1881 1337 578 840 1832 529 
1 8 529 1169 1028 784 1789 235 787 1253 
1 8 529 388 1765 459 1159 903 1672 1647 
1 9 1253 1752 1735 174 255 232 1392 662 1647 
2 16 598 1769 605 1741 134 1692 131 1675 865 113 1676 1669 956 245 772 1647 
2 10 1647 1629 1612 322 1569 1191 1130 249 728 273 
1 9 935 336 1219 179 1731 169 917 1706 1697 
1 7 744 1080 1180 745 384 1381 935 
1 2 99 570 
1 7 1213 1077 1901 558 425 287 99 
1 6 570 1987 1991 2000 2007 724 
1 7 724 574 1351 2014 668 69 629 
1 9 629 2040 50 1135 1134 688 95 798 2063 
2 14 212 893 525 1038 290 1982 1970 1186 899 132 478 1380 1080 744 
2 8 654 638 996 1147 1300 1207 862 212 
2 5 654 667 2078 706 593 
1 8 654 962 930 1404 278 735 276 724 
1 6 1124 554 103 844 798 2063 
2 9 593 24 1343 78 1350 458 2116 2118 253 
1 7 14 546 2137 625 1356 2124 253 
2 11 14 1289 563 2131 997 2125 33 2109 915 2102 1124 
2 7 2068 552 909 218 374 938 1124 
1 5 427 77 332 964 2068 
1 5 724 1255 2044 2054 427 
1 9 1101 1929 28 1301 1992 337 1353 893 212 
1 7 935 347 1842 261 1874 1895 1101 
1 9 182 1607 747 1585 1001 1555 748 1516 273 
1 17 182 734 396 1634 954 1643 1035 1659 284 753 170 403 1658 842 98 1685 1697 
1 10 1506 466 541 483 1492 520 141 843 686 273 
1 13 1167 1212 1040 1489 890 216 1199 1507 23 920 805 495 1506 
1 10 898 61 1564 124 999 1508 354 1495 1146 1167 
1 10 422 1748 1171 192 1682 186 1259 1628 610 898 
1 7 422 731 331 1762 450 1776 1253 
1 14 1647 662 1272 303 1625 817 338 1280 916 859 111 1615 610 898 
1 12 1422 1426 227 1434 1441 1284 833 324 1456 1459 1317 1167 
1 5 1335 87 1439 198 1422 
2 13 53 1550 637 717 1518 1355 1497 1479 838 57 1461 1074 1335 
2 8 1544 1551 364 1004 1539 637 1550 53 
1 8 898 61 1588 1330 130 1574 1371 53 
2 10 498 871 1197 509 622 1411 1390 117 1561 1544 
1 13 53 108 1603 251 1631 1648 678 1703 1720 796 1387 1220 498 
1 11 1349 550 894 1877 1864 355 655 18 1804 1787 498 
2 8 401 1996 288 269 15 611 1961 1349 
1 5 1206 1801 827 329 422 
2 7 1206 1848 766 841 490 386 1349 
1 7 1206 1189 353 368 1855 438 521 
1 4 532 1792 148 1206 
1 9 1631 359 1084 487 1718 1753 1152 464 532 
1 15 1364 673 1913 1903 1894 70 1880 358 697 1818 869 1803 257 787 1253 
